███████████████████████
██████████■████████████
██████████ ████████████
█   █   ██ ███     ██ █
█ █ █ █ █  ███ █ █ ██ █
█ █   █   ████ █ █ ██ █
█████████      █ █ ██ █
█████████ ██████ █    █
█         █    █ ██████
█ ███████ █ ████ ██████
█         █ ████ █    █
█ █████ ███      █ ██ █
█ █████ █████ ████ ██ █
█V      █E         ██ █
█████████ █ █ █ █ ███ █
█         █ █ █ █ ██  █
█ █████████       ██ ██
█         ██ █ █ ██  ██
███████████       █ ███
█           █ █ █ █ ███
███████████       █ ███
█     O    █ █ █ ██   █
██████████       ████ █
█████████████████████F█
███████████████████████