███████████████████████
██████████■████████████
██████████ ████████████
██████████ ████████████
█████████  ████████████
█████████ █████████████
█████████        ██████
█████████ ██████ ██████
█         █    █ ██████
█ ███████ █ ████ ██████
█         █ ████ █    █
█ █████ ███      █ ██ █
█ █████ █████ ████ ██ █
█V      █E         ██ █
█████████ ███████████ █
█         ███████████ █
█ █████████████████   █
█         █████████ ███
███████████       █ ███
█                 █ ███
███████████       █ ███
█     O    █ █ █ ██   █
██████████       ████ █
███████████████████F  █
███████████████████████